26 26 18 5 3    0 24    10 24    24 24
0 0 0 0 0 0 0 0 3 3 0 0 0 0 0 0 0 0 0 0 0 0 0 0 0 0
0 0 0 0 0 0 0 0 3 3 0 0 0 0 0 0 0 0 0 0 0 0 0 0 0 0
3 3 3 3 0 0 0 0 3 3 0 0 0 0 3 3 3 3 0 0 0 0 0 0 0 0
3 3 3 3 0 0 0 0 3 3 0 0 0 0 3 3 3 3 0 0 0 0 0 0 0 0
0 0 3 3 0 0 0 0 3 3 0 0 0 0 0 0 3 3 0 0 3 3 3 3 5 5
0 0 3 3 0 0 0 0 3 3 0 0 0 0 0 0 3 3 0 0 3 3 3 3 5 5
0 0 3 3 0 0 0 0 3 3 3 3 3 3 0 0 5 5 0 0 3 3 0 0 0 0
0 0 3 3 0 0 0 0 3 3 3 3 3 3 0 0 5 5 0 0 3 3 0 0 0 0
0 0 2 2 0 0 0 0 0 0 0 0 3 3 0 0 3 3 3 3 3 3 0 0 0 0
0 0 0 0 0 0 0 0 0 0 0 0 0 0 0 0 0 0 0 0 0 0 0 0 0 0
5 5 0 0 0 0 0 0 0 0 0 0 0 0 0 0 0 0 0 0 0 0 0 0 0 0
5 5 3 3 3 3 0 0 3 3 2 2 3 3 0 0 2 2 0 0 0 0 0 0 0 0
0 0 0 0 3 3 5 5 3 3 5 5 0 0 0 0 2 2 0 0 0 0 3 3 3 3
0 0 0 0 3 3 5 5 3 3 5 5 0 0 0 0 2 2 0 0 0 0 3 3 3 3
0 0 0 0 3 3 0 0 0 0 5 5 0 0 0 0 3 3 0 0 0 0 3 3 0 0
0 0 0 0 3 3 0 0 0 0 5 5 0 0 0 0 3 3 0 0 0 0 3 3 0 0
0 0 0 0 2 2 0 0 0 0 3 3 0 0 0 0 3 3 3 3 2 2 3 3 0 0
0 0 0 0 2 2 0 0 0 0 3 3 0 0 0 0 3 3 3 3 2 2 3 3 0 0
5 5 3 3 3 3 3 3 5 5 5 5 2 2 3 3 3 3 0 0 2 2 3 3 0 0
5 5 3 3 3 3 3 3 5 5 5 5 2 2 3 3 3 3 0 0 2 2 3 3 0 0
0 0 0 0 0 0 2 2 0 0 0 0 0 0 0 0 5 5 5 5 0 0 2 2 0 0
0 0 0 0 0 0 2 2 0 0 0 0 0 0 0 0 5 5 5 5 0 0 2 2 0 0
0 0 0 0 0 0 3 3 0 0 0 0 0 0 0 0 0 0 5 5 0 0 2 2 0 0
0 0 0 0 0 0 3 3 0 0 0 2 2 2 2 0 0 0 5 5 0 0 2 2 0 0
0 0 0 0 0 0 3 3 0 0 0 2 0 0 2 0 0 0 3 3 0 0 2 2 0 0
0 0 0 0 0 0 3 3 0 0 0 2 1 0 2 0 0 0 3 3 0 0 2 2 0 0

# 注释
# 0 none
# 1 home
# 2 brick
# 3 iron
# 4 river
# 5 tree
# 6 ice