26 26 17 5 3    0 24    10 24    24 24
# 场地大小：26*26,共有17个敌人，场上最多同时存在5个敌人，敌人共3个出生点 
# 26 26 17 5 1    4 0
0 0 0 0 0 0 4 4 0 0 0 0 0 0 0 0 4 4 0 0 0 0 0 0 0 0
0 0 0 0 0 0 4 4 0 0 0 0 0 0 0 0 4 4 0 0 0 0 0 0 0 0
4 4 4 4 0 0 4 4 0 0 4 4 4 4 4 4 4 4 0 0 4 4 4 4 4 4
4 4 4 4 0 0 4 4 0 0 4 4 4 4 4 4 4 4 0 0 4 4 4 4 4 4
5 5 5 5 0 0 0 0 0 0 0 0 0 0 0 0 4 4 0 0 4 4 5 5 4 4
5 5 5 5 0 0 0 0 0 0 0 0 0 0 0 0 4 4 0 0 4 4 5 5 4 4
5 5 4 4 4 4 4 4 4 4 0 0 3 0 0 0 0 0 0 0 5 5 5 5 5 5
5 5 4 4 4 4 4 4 4 4 0 0 3 0 0 0 0 0 0 0 5 5 5 5 5 5
5 5 5 5 0 0 4 4 0 0 0 0 4 4 0 0 4 4 4 4 4 4 4 4 5 5
5 5 5 5 0 0 4 4 0 0 0 0 4 4 0 0 4 4 4 4 4 4 4 4 5 5
4 4 4 4 0 0 4 4 0 0 4 4 4 4 0 0 0 0 4 4 0 0 0 0 0 0
4 4 4 4 0 0 4 4 0 0 4 4 4 4 0 0 0 0 4 4 0 0 0 0 0 0
0 0 0 0 0 0 5 5 2 2 0 0 2 0 5 5 0 0 4 4 0 0 0 0 4 4
0 0 0 0 0 0 5 5 2 2 0 0 2 0 5 5 0 0 4 4 0 0 0 0 4 4
0 0 4 4 4 4 5 5 4 4 4 4 4 4 4 4 0 0 5 5 2 2 0 0 4 4
0 0 4 4 4 4 5 5 4 4 4 4 4 4 4 4 0 0 5 5 2 2 0 0 4 4
0 0 0 0 0 0 2 2 0 0 0 0 4 4 0 0 5 5 5 5 4 4 0 0 4 4
0 0 0 0 0 0 2 2 0 0 0 0 4 4 0 0 5 5 5 5 4 4 0 0 4 4
4 4 4 4 0 0 4 4 4 4 0 0 4 4 0 2 4 4 4 4 4 4 0 0 0 0
4 4 4 4 0 0 4 4 4 4 0 0 4 4 0 2 4 4 4 4 4 4 0 0 0 0
0 0 0 0 0 0 0 0 5 5 5 5 0 0 0 0 5 5 4 4 0 0 0 0 4 4
0 0 0 0 0 0 0 0 5 5 5 5 0 0 0 0 5 5 4 4 0 0 0 0 4 4
0 0 4 4 4 4 4 4 5 5 0 0 0 0 0 0 0 0 4 4 0 0 4 4 4 4
0 0 4 4 4 4 4 4 5 5 0 2 2 2 2 0 0 0 4 4 0 0 4 4 4 4
0 0 4 4 0 0 0 0 0 0 0 2 0 0 2 0 0 0 0 0 0 0 0 0 0 0
0 0 4 4 0 0 0 0 0 0 0 2 1 0 2 0 0 0 0 0 0 0 0 0 0 0

# 注释
# 0 none
# 1 home
# 2 brick
# 3 iron
# 4 river
# 5 tree
# 6 ice